...............
#######......##
#.......#######
######....#####
#######.#######
#######.#######
#######.#######
#####.....#####
###....########

