#..##.#
#.#####
#.#####
#.#####
#.....#
#.#####
....###
#...#.#
\robot 1 0
\robot 1 3
\robot 1 4
