#####.#
###...#
###.###
###...#
##..###
##...##
#######
\robot 2 1
